20
1 1 18 18
11111111111111111111
10000000001111100001
10111111010100010101
10100001010111010101
10101111010001010101
10100000011101010101
10111111000101000101
10000000110101111101
11111110110100000001
10000000110111111111
10111110110000000001
10100000111111111001
10101111100000001001
10100000101111101001
10111110101000101001
10000010101011101001
11111010100010101001
10000010111110101001
10111110000000100001
11111111111111111111
